24
12
O**********************O
|        x             |
|                      |
|      O**O            |
|                      |
|    H     $         @ |
|                      |
|                      |
|                      |
|                      |
|                      |
O**********************O